"filename", "language", "C#", "JSON", "comment", "blank", "total"
"/Users/fujitayuuta/Documents/GitHub/ZangiDon_001/Assets/Project/Script/Asset/Bullet/Context/DamageCorrectionContext.cs", "C#", 24, 0, 0, 6, 30
"/Users/fujitayuuta/Documents/GitHub/ZangiDon_001/Assets/Project/Script/Asset/Bullet/Context/HomingCorrectionContext.cs", "C#", 16, 0, 0, 5, 21
"/Users/fujitayuuta/Documents/GitHub/ZangiDon_001/Assets/Project/Script/Asset/Bullet/Context/Interface/IDamageCorrectionContext.cs", "C#", 8, 0, 3, 3, 14
"/Users/fujitayuuta/Documents/GitHub/ZangiDon_001/Assets/Project/Script/Asset/Castable/DummyCastable.cs", "C#", 9, 0, 0, 2, 11
"/Users/fujitayuuta/Documents/GitHub/ZangiDon_001/Assets/Project/Script/Asset/EffectHolder/ApplyStatusEffect.cs", "C#", 16, 0, 0, 3, 19
"/Users/fujitayuuta/Documents/GitHub/ZangiDon_001/Assets/Project/Script/Asset/EffectHolder/GiveDamage.cs", "C#", 0, 0, 0, 1, 1
"/Users/fujitayuuta/Documents/GitHub/ZangiDon_001/Assets/Project/Script/Asset/EffectHolder/HealHealth.cs", "C#", 21, 0, 3, 5, 29
"/Users/fujitayuuta/Documents/GitHub/ZangiDon_001/Assets/Project/Script/Asset/Status/Health/DamageModule.cs", "C#", 35, 0, 0, 13, 48
"/Users/fujitayuuta/Documents/GitHub/ZangiDon_001/Assets/Project/Script/Asset/Status/Health/HealModule.cs", "C#", 40, 0, 0, 12, 52
"/Users/fujitayuuta/Documents/GitHub/ZangiDon_001/Assets/Project/Script/Asset/Status/Health/Health.cs", "C#", 38, 0, 0, 14, 52
"/Users/fujitayuuta/Documents/GitHub/ZangiDon_001/Assets/Project/Script/Asset/Status/Health/Interface/IDamageable.cs", "C#", 9, 0, 3, 7, 19
"/Users/fujitayuuta/Documents/GitHub/ZangiDon_001/Assets/Project/Script/Asset/Status/Health/Interface/IHealable.cs", "C#", 12, 0, 16, 8, 36
"/Users/fujitayuuta/Documents/GitHub/ZangiDon_001/Assets/Project/Script/Asset/Status/Health/Interface/IHealth.cs", "C#", 10, 0, 0, 3, 13
"/Users/fujitayuuta/Documents/GitHub/ZangiDon_001/Assets/Project/Script/Asset/Status/Health/Interface/IMaxHealth.cs", "C#", 6, 0, 0, 2, 8
"/Users/fujitayuuta/Documents/GitHub/ZangiDon_001/Assets/Project/Script/Asset/Status/Health/MaxHealth.cs", "C#", 7, 0, 0, 2, 9
"/Users/fujitayuuta/Documents/GitHub/ZangiDon_001/Assets/Project/Script/Asset/StatusEffect/HealCorrect.cs", "C#", 21, 0, 0, 7, 28
"/Users/fujitayuuta/Documents/GitHub/ZangiDon_001/Assets/Project/Script/Asset/TargetSelector/RoundFromSelfSelector.cs", "C#", 15, 0, 3, 3, 21
"/Users/fujitayuuta/Documents/GitHub/ZangiDon_001/Assets/Project/Script/Asset/TargetSelector/SelfSelector.cs", "C#", 12, 0, 3, 1, 16
"/Users/fujitayuuta/Documents/GitHub/ZangiDon_001/Assets/Project/Script/Bullet/Context/Asset/AccelerationCorrector.cs", "C#", 18, 0, 0, 4, 22
"/Users/fujitayuuta/Documents/GitHub/ZangiDon_001/Assets/Project/Script/Bullet/Context/Asset/FirstSpeedCorrector.cs", "C#", 29, 0, 0, 5, 34
"/Users/fujitayuuta/Documents/GitHub/ZangiDon_001/Assets/Project/Script/Bullet/Context/BulletContext.cs", "C#", 30, 0, 7, 9, 46
"/Users/fujitayuuta/Documents/GitHub/ZangiDon_001/Assets/Project/Script/Bullet/Context/BulletContextManager.cs", "C#", 44, 0, 3, 15, 62
"/Users/fujitayuuta/Documents/GitHub/ZangiDon_001/Assets/Project/Script/Bullet/Context/Helper/BulletContextHelper.cs", "C#", 31, 0, 1, 9, 41
"/Users/fujitayuuta/Documents/GitHub/ZangiDon_001/Assets/Project/Script/Bullet/Context/Intetface/IBulletContext.cs", "C#", 8, 0, 7, 5, 20
"/Users/fujitayuuta/Documents/GitHub/ZangiDon_001/Assets/Project/Script/Bullet/Context/Intetface/IBulletContextApplicable.cs", "C#", 5, 0, 7, 3, 15
"/Users/fujitayuuta/Documents/GitHub/ZangiDon_001/Assets/Project/Script/Bullet/Context/Intetface/IBulletContextElement.cs", "C#", 6, 0, 7, 3, 16
"/Users/fujitayuuta/Documents/GitHub/ZangiDon_001/Assets/Project/Script/Bullet/Context/Intetface/IBulletContextHolder.cs", "C#", 5, 0, 0, 0, 5
"/Users/fujitayuuta/Documents/GitHub/ZangiDon_001/Assets/Project/Script/Bullet/Context/Intetface/IBulletDamageCorrection.cs", "C#", 8, 0, 3, 2, 13
"/Users/fujitayuuta/Documents/GitHub/ZangiDon_001/Assets/Project/Script/Bullet/Damage/DamageManager.cs", "C#", 16, 0, 3, 9, 28
"/Users/fujitayuuta/Documents/GitHub/ZangiDon_001/Assets/Project/Script/Bullet/Damage/Interface/IBulletDamageHolder.cs", "C#", 7, 0, 3, 3, 13
"/Users/fujitayuuta/Documents/GitHub/ZangiDon_001/Assets/Project/Script/Bullet/Damage/Interface/IDamageExecutor.cs", "C#", 6, 0, 3, 1, 10
"/Users/fujitayuuta/Documents/GitHub/ZangiDon_001/Assets/Project/Script/Bullet/Data/BulletData.cs", "C#", 10, 0, 0, 3, 13
"/Users/fujitayuuta/Documents/GitHub/ZangiDon_001/Assets/Project/Script/Bullet/Data/Element/EffectElement.cs", "C#", 13, 0, 3, 3, 19
"/Users/fujitayuuta/Documents/GitHub/ZangiDon_001/Assets/Project/Script/Bullet/Data/Element/KnockBackElement.cs", "C#", 14, 0, 0, 5, 19
"/Users/fujitayuuta/Documents/GitHub/ZangiDon_001/Assets/Project/Script/Bullet/Destroy/Conditions/ADestroyCondition.cs", "C#", 15, 0, 0, 6, 21
"/Users/fujitayuuta/Documents/GitHub/ZangiDon_001/Assets/Project/Script/Bullet/Destroy/Conditions/RangeDestroyCondition.cs", "C#", 36, 0, 0, 7, 43
"/Users/fujitayuuta/Documents/GitHub/ZangiDon_001/Assets/Project/Script/Bullet/Destroy/DestroyConditionManager.cs", "C#", 49, 0, 3, 15, 67
"/Users/fujitayuuta/Documents/GitHub/ZangiDon_001/Assets/Project/Script/Bullet/Destroy/Interface/IDestroyCondition.cs", "C#", 9, 0, 12, 3, 24
"/Users/fujitayuuta/Documents/GitHub/ZangiDon_001/Assets/Project/Script/Bullet/Homing/HomingModule.cs", "C#", 12, 0, 3, 5, 20
"/Users/fujitayuuta/Documents/GitHub/ZangiDon_001/Assets/Project/Script/Bullet/Homing/Interface/IAbleHomingJudger.cs", "C#", 5, 0, 3, 2, 10
"/Users/fujitayuuta/Documents/GitHub/ZangiDon_001/Assets/Project/Script/Bullet/Instance/Factory/BulletFactory.cs", "C#", 24, 0, 0, 7, 31
"/Users/fujitayuuta/Documents/GitHub/ZangiDon_001/Assets/Project/Script/Bullet/Instance/Interface/IBulletFactory.cs", "C#", 8, 0, 0, 1, 9
"/Users/fujitayuuta/Documents/GitHub/ZangiDon_001/Assets/Project/Script/Bullet/Movement/Acceleration/ConstantAcceleration.cs", "C#", 26, 0, 3, 9, 38
"/Users/fujitayuuta/Documents/GitHub/ZangiDon_001/Assets/Project/Script/Bullet/Movement/Acceleration/Interface/IBulletAccelaretionHolder.cs", "C#", 8, 0, 3, 3, 14
"/Users/fujitayuuta/Documents/GitHub/ZangiDon_001/Assets/Project/Script/Bullet/Movement/Acceleration/VariableAcceleration.cs", "C#", 50, 0, 0, 22, 72
"/Users/fujitayuuta/Documents/GitHub/ZangiDon_001/Assets/Project/Script/Bullet/Movement/BulletMoveExecutor.cs", "C#", 44, 0, 3, 16, 63
"/Users/fujitayuuta/Documents/GitHub/ZangiDon_001/Assets/Project/Script/Bullet/Movement/BulletSpeedManager.cs", "C#", 52, 0, 0, 19, 71
"/Users/fujitayuuta/Documents/GitHub/ZangiDon_001/Assets/Project/Script/Bullet/Movement/Direction/DirectionManager.cs", "C#", 35, 0, 3, 7, 45
"/Users/fujitayuuta/Documents/GitHub/ZangiDon_001/Assets/Project/Script/Bullet/Movement/Direction/Interface/IMoveDirectionHolder.cs", "C#", 6, 0, 6, 1, 13
"/Users/fujitayuuta/Documents/GitHub/ZangiDon_001/Assets/Project/Script/Bullet/Movement/Direction/Pattern/DebugDirectionPattern.cs", "C#", 16, 0, 3, 7, 26
"/Users/fujitayuuta/Documents/GitHub/ZangiDon_001/Assets/Project/Script/Bullet/Movement/Direction/Pattern/Interface/IDirectionPattern.cs", "C#", 8, 0, 7, 4, 19
"/Users/fujitayuuta/Documents/GitHub/ZangiDon_001/Assets/Project/Script/Bullet/Movement/Direction/Pattern/StraightPattern.cs", "C#", 28, 0, 3, 10, 41
"/Users/fujitayuuta/Documents/GitHub/ZangiDon_001/Assets/Project/Script/Bullet/Movement/Direction/Pattern/TargetDirectionManager.cs", "C#", 23, 0, 0, 7, 30
"/Users/fujitayuuta/Documents/GitHub/ZangiDon_001/Assets/Project/Script/Bullet/Movement/FirstSpeed/Interface/IBulletFirstSpeedHolder.cs", "C#", 8, 0, 6, 2, 16
"/Users/fujitayuuta/Documents/GitHub/ZangiDon_001/Assets/Project/Script/Bullet/Movement/FirstSpeed/NormalFirstSpeed.cs", "C#", 36, 0, 0, 11, 47
"/Users/fujitayuuta/Documents/GitHub/ZangiDon_001/Assets/Project/Script/Bullet/Movement/Interface/IBulletSpeedHolder.cs", "C#", 6, 0, 3, 1, 10
"/Users/fujitayuuta/Documents/GitHub/ZangiDon_001/Assets/Project/Script/Bullet/Range/BulletRangeCounter.cs", "C#", 33, 0, 0, 13, 46
"/Users/fujitayuuta/Documents/GitHub/ZangiDon_001/Assets/Project/Script/Bullet/Range/Interface/IRangeCounter.cs", "C#", 5, 0, 3, 0, 8
"/Users/fujitayuuta/Documents/GitHub/ZangiDon_001/Assets/Project/Script/Bullet/Target/BulletTargetHolder.cs", "C#", 17, 0, 3, 6, 26
"/Users/fujitayuuta/Documents/GitHub/ZangiDon_001/Assets/Project/Script/Bullet/Target/Interface/IBulletTargetHolder.cs", "C#", 6, 0, 0, 2, 8
"/Users/fujitayuuta/Documents/GitHub/ZangiDon_001/Assets/Project/Script/Camera/Angle/Interface/ICameraAngleCalculater.cs", "C#", 6, 0, 7, 1, 14
"/Users/fujitayuuta/Documents/GitHub/ZangiDon_001/Assets/Project/Script/Camera/Angle/Interface/ICameraAngleHolder.cs", "C#", 7, 0, 0, 2, 9
"/Users/fujitayuuta/Documents/GitHub/ZangiDon_001/Assets/Project/Script/Camera/Angle/Interface/ICameraAngleLimiter.cs", "C#", 6, 0, 8, 2, 16
"/Users/fujitayuuta/Documents/GitHub/ZangiDon_001/Assets/Project/Script/Camera/Angle/Limiter/NormalAngleLimiter.cs", "C#", 23, 0, 0, 9, 32
"/Users/fujitayuuta/Documents/GitHub/ZangiDon_001/Assets/Project/Script/Camera/Angle/NormalAngleCalculater.cs", "C#", 28, 0, 0, 11, 39
"/Users/fujitayuuta/Documents/GitHub/ZangiDon_001/Assets/Project/Script/Camera/Angle/NormalAngleController.cs", "C#", 63, 0, 3, 19, 85
"/Users/fujitayuuta/Documents/GitHub/ZangiDon_001/Assets/Project/Script/Camera/CameraBrain.cs", "C#", 51, 0, 3, 20, 74
"/Users/fujitayuuta/Documents/GitHub/ZangiDon_001/Assets/Project/Script/Camera/Interface/ICameraControlElement.cs", "C#", 7, 0, 8, 3, 18
"/Users/fujitayuuta/Documents/GitHub/ZangiDon_001/Assets/Project/Script/Camera/Position/Interface/ICameraOffSetHolder.cs", "C#", 6, 0, 9, 2, 17
"/Users/fujitayuuta/Documents/GitHub/ZangiDon_001/Assets/Project/Script/Camera/Position/Interface/ICameraPositionCalculator.cs", "C#", 6, 0, 3, 1, 10
"/Users/fujitayuuta/Documents/GitHub/ZangiDon_001/Assets/Project/Script/Camera/Position/Interface/ICameraPositionHolder.cs", "C#", 8, 0, 6, 4, 18
"/Users/fujitayuuta/Documents/GitHub/ZangiDon_001/Assets/Project/Script/Camera/Position/NormalOffsetController.cs", "C#", 21, 0, 0, 6, 27
"/Users/fujitayuuta/Documents/GitHub/ZangiDon_001/Assets/Project/Script/Camera/Position/NormalPositionCalculator.cs", "C#", 32, 0, 2, 11, 45
"/Users/fujitayuuta/Documents/GitHub/ZangiDon_001/Assets/Project/Script/Camera/Position/NormalPositionController.cs", "C#", 95, 0, 12, 27, 134
"/Users/fujitayuuta/Documents/GitHub/ZangiDon_001/Assets/Project/Script/Camera/Smooth/Interface/IAngleSmoothHolder.cs", "C#", 5, 0, 3, 2, 10
"/Users/fujitayuuta/Documents/GitHub/ZangiDon_001/Assets/Project/Script/Camera/Smooth/Interface/IMoveSmoothHolder.cs", "C#", 4, 0, 3, 1, 8
"/Users/fujitayuuta/Documents/GitHub/ZangiDon_001/Assets/Project/Script/Camera/Smooth/Interface/ISmoothHolder.cs", "C#", 6, 0, 3, 1, 10
"/Users/fujitayuuta/Documents/GitHub/ZangiDon_001/Assets/Project/Script/Camera/Smooth/RelativeMoveSmooth.cs", "C#", 50, 0, 4, 20, 74
"/Users/fujitayuuta/Documents/GitHub/ZangiDon_001/Assets/Project/Script/Character/Data/CharacterData.cs", "C#", 11, 0, 0, 3, 14
"/Users/fujitayuuta/Documents/GitHub/ZangiDon_001/Assets/Project/Script/Character/Data/Element/StatusElement.cs", "C#", 11, 0, 0, 4, 15
"/Users/fujitayuuta/Documents/GitHub/ZangiDon_001/Assets/Project/Script/Character/Data/Element/TagsElement.cs", "C#", 12, 0, 0, 3, 15
"/Users/fujitayuuta/Documents/GitHub/ZangiDon_001/Assets/Project/Script/Character/Data/Interface/ICharacterDataHolder.cs", "C#", 5, 0, 0, 0, 5
"/Users/fujitayuuta/Documents/GitHub/ZangiDon_001/Assets/Project/Script/Character/LockManage/Interface/ILockTargetHolder.cs", "C#", 6, 0, 0, 2, 8
"/Users/fujitayuuta/Documents/GitHub/ZangiDon_001/Assets/Project/Script/Character/LockManage/Interface/ITargetContext.cs", "C#", 9, 0, 9, 5, 23
"/Users/fujitayuuta/Documents/GitHub/ZangiDon_001/Assets/Project/Script/Character/LockManage/Interface/ITargetContextHolder.cs", "C#", 5, 0, 0, 0, 5
"/Users/fujitayuuta/Documents/GitHub/ZangiDon_001/Assets/Project/Script/Character/LockManage/LockTargetManger.cs", "C#", 11, 0, 0, 5, 16
"/Users/fujitayuuta/Documents/GitHub/ZangiDon_001/Assets/Project/Script/Character/LockManage/TargetContext.cs", "C#", 101, 0, 1, 23, 125
"/Users/fujitayuuta/Documents/GitHub/ZangiDon_001/Assets/Project/Script/Character/LockManage/TargetContextManager.cs", "C#", 23, 0, 0, 10, 33
"/Users/fujitayuuta/Documents/GitHub/ZangiDon_001/Assets/Project/Script/Character/Shooter/CharacterMagicShoter.cs", "C#", 26, 0, 0, 7, 33
"/Users/fujitayuuta/Documents/GitHub/ZangiDon_001/Assets/Project/Script/Character/Shooter/ContextManager.cs", "C#", 58, 0, 3, 17, 78
"/Users/fujitayuuta/Documents/GitHub/ZangiDon_001/Assets/Project/Script/Character/Tag/ACharacterTag.cs", "C#", 8, 0, 0, 2, 10
"/Users/fujitayuuta/Documents/GitHub/ZangiDon_001/Assets/Project/Script/Character/Tag/CharacterTagManager.cs", "C#", 40, 0, 0, 11, 51
"/Users/fujitayuuta/Documents/GitHub/ZangiDon_001/Assets/Project/Script/Character/Tag/Interface/ICharacterTag.cs", "C#", 4, 0, 0, 1, 5
"/Users/fujitayuuta/Documents/GitHub/ZangiDon_001/Assets/Project/Script/Character/Tag/Interface/ICharacterTagHolder.cs", "C#", 9, 0, 0, 4, 13
"/Users/fujitayuuta/Documents/GitHub/ZangiDon_001/Assets/Project/Script/Controller/RuneSelectInput.cs", "C#", 17, 0, 0, 7, 24
"/Users/fujitayuuta/Documents/GitHub/ZangiDon_001/Assets/Project/Script/Enemy/Data/EnemyData.cs", "C#", 10, 0, 3, 3, 16
"/Users/fujitayuuta/Documents/GitHub/ZangiDon_001/Assets/Project/Script/EventBus/Character/TakeDamageEventBus.cs", "C#", 7, 0, 0, 2, 9
"/Users/fujitayuuta/Documents/GitHub/ZangiDon_001/Assets/Project/Script/EventBus/EntityDeath.cs", "C#", 9, 0, 0, 3, 12
"/Users/fujitayuuta/Documents/GitHub/ZangiDon_001/Assets/Project/Script/EventBus/EntitySpown.cs", "C#", 11, 0, 3, 6, 20
"/Users/fujitayuuta/Documents/GitHub/ZangiDon_001/Assets/Project/Script/EventBus/EntityTakeDamage.cs", "C#", 12, 0, 3, 5, 20
"/Users/fujitayuuta/Documents/GitHub/ZangiDon_001/Assets/Project/Script/GameManager/EntityManager.cs", "C#", 43, 0, 3, 17, 63
"/Users/fujitayuuta/Documents/GitHub/ZangiDon_001/Assets/Project/Script/GameManager/Interface/IEntityManager.cs", "C#", 7, 0, 4, 2, 13
"/Users/fujitayuuta/Documents/GitHub/ZangiDon_001/Assets/Project/Script/Installer/Bullet/BulletInstaller.cs", "C#", 14, 0, 0, 8, 22
"/Users/fujitayuuta/Documents/GitHub/ZangiDon_001/Assets/Project/Script/Installer/Camera/CameraInstaller.cs", "C#", 13, 0, 0, 4, 17
"/Users/fujitayuuta/Documents/GitHub/ZangiDon_001/Assets/Project/Script/Installer/Character/CharacterInstaller.cs", "C#", 24, 0, 1, 9, 34
"/Users/fujitayuuta/Documents/GitHub/ZangiDon_001/Assets/Project/Script/Installer/Character/Player/PlayerInstaller.cs", "C#", 19, 0, 0, 7, 26
"/Users/fujitayuuta/Documents/GitHub/ZangiDon_001/Assets/Project/Script/Installer/Character/Player/RuneReferenceInstaller.cs", "C#", 24, 0, 3, 10, 37
"/Users/fujitayuuta/Documents/GitHub/ZangiDon_001/Assets/Project/Script/Installer/Character/Player/ShooterReferenceInstaller.cs", "C#", 22, 0, 0, 7, 29
"/Users/fujitayuuta/Documents/GitHub/ZangiDon_001/Assets/Project/Script/Installer/GamaManager/EntityManagerInstaller.cs", "C#", 18, 0, 0, 5, 23
"/Users/fujitayuuta/Documents/GitHub/ZangiDon_001/Assets/Project/Script/Installer/GamaManager/GameManagerInstaller.cs", "C#", 10, 0, 0, 2, 12
"/Users/fujitayuuta/Documents/GitHub/ZangiDon_001/Assets/Project/Script/Installer/InstallerList.cs", "C#", 12, 0, 0, 6, 18
"/Users/fujitayuuta/Documents/GitHub/ZangiDon_001/Assets/Project/Script/Installer/Interface/IInstallerList.cs", "C#", 7, 0, 0, 4, 11
"/Users/fujitayuuta/Documents/GitHub/ZangiDon_001/Assets/Project/Script/Installer/UI/PlayerHUD/PlayerHUDInstaller.cs", "C#", 15, 0, 0, 8, 23
"/Users/fujitayuuta/Documents/GitHub/ZangiDon_001/Assets/Project/Script/Installer/UI/PlayerHUD/PlayerHealthBarInstaller.cs", "C#", 26, 0, 3, 7, 36
"/Users/fujitayuuta/Documents/GitHub/ZangiDon_001/Assets/Project/Script/Installer/UI/PlayerHUD/RuneUI/MainRuneSlotInstaller.cs", "C#", 21, 0, 0, 7, 28
"/Users/fujitayuuta/Documents/GitHub/ZangiDon_001/Assets/Project/Script/Installer/UI/PlayerHUD/RuneUI/RuneSelectorInstaller.cs", "C#", 21, 0, 0, 8, 29
"/Users/fujitayuuta/Documents/GitHub/ZangiDon_001/Assets/Project/Script/Installer/UI/PlayerHUD/RuneUI/SubRuneSlotInstaller.cs", "C#", 21, 0, 0, 7, 28
"/Users/fujitayuuta/Documents/GitHub/ZangiDon_001/Assets/Project/Script/Interface/IOnDestroy.cs", "C#", 8, 0, 6, 0, 14
"/Users/fujitayuuta/Documents/GitHub/ZangiDon_001/Assets/Project/Script/Interface/IOnFixedUpdate.cs", "C#", 8, 0, 3, 1, 12
"/Users/fujitayuuta/Documents/GitHub/ZangiDon_001/Assets/Project/Script/Interface/IOnInstance.cs", "C#", 8, 0, 7, 0, 15
"/Users/fujitayuuta/Documents/GitHub/ZangiDon_001/Assets/Project/Script/Interface/IOnStart.cs", "C#", 8, 0, 2, 1, 11
"/Users/fujitayuuta/Documents/GitHub/ZangiDon_001/Assets/Project/Script/Interface/IOnUpdate.cs", "C#", 8, 0, 7, 1, 16
"/Users/fujitayuuta/Documents/GitHub/ZangiDon_001/Assets/Project/Script/Interface/IReceiveHandler.cs", "C#", 6, 0, 4, 2, 12
"/Users/fujitayuuta/Documents/GitHub/ZangiDon_001/Assets/Project/Script/Interface/IReceiver.cs", "C#", 7, 0, 4, 3, 14
"/Users/fujitayuuta/Documents/GitHub/ZangiDon_001/Assets/Project/Script/Interface/ISender.cs", "C#", 8, 0, 18, 3, 29
"/Users/fujitayuuta/Documents/GitHub/ZangiDon_001/Assets/Project/Script/Interface/Interface.asmdef", "JSON", 0, 14, 0, 0, 14
"/Users/fujitayuuta/Documents/GitHub/ZangiDon_001/Assets/Project/Script/Rune/Definition/ActivateTiming.cs", "C#", 8, 0, 12, 0, 20
"/Users/fujitayuuta/Documents/GitHub/ZangiDon_001/Assets/Project/Script/Rune/Effect/EffectInstance.cs", "C#", 25, 0, 7, 6, 38
"/Users/fujitayuuta/Documents/GitHub/ZangiDon_001/Assets/Project/Script/Rune/Effect/Interface/IEffect.cs", "C#", 6, 0, 0, 1, 7
"/Users/fujitayuuta/Documents/GitHub/ZangiDon_001/Assets/Project/Script/Rune/Effect/Interface/IEffectHolder.cs", "C#", 7, 0, 7, 1, 15
"/Users/fujitayuuta/Documents/GitHub/ZangiDon_001/Assets/Project/Script/Rune/Effect/Interface/ITargetSelector.cs", "C#", 7, 0, 8, 1, 16
"/Users/fujitayuuta/Documents/GitHub/ZangiDon_001/Assets/Project/Script/Rune/Interface/IRune.cs", "C#", 9, 0, 6, 7, 22
"/Users/fujitayuuta/Documents/GitHub/ZangiDon_001/Assets/Project/Script/Rune/Interface/IRuneDisposeHandler.cs", "C#", 6, 0, 0, 1, 7
"/Users/fujitayuuta/Documents/GitHub/ZangiDon_001/Assets/Project/Script/Rune/MagicCastModule.cs", "C#", 35, 0, 0, 8, 43
"/Users/fujitayuuta/Documents/GitHub/ZangiDon_001/Assets/Project/Script/Rune/Manager/ARuneManager.cs", "C#", 119, 0, 6, 35, 160
"/Users/fujitayuuta/Documents/GitHub/ZangiDon_001/Assets/Project/Script/Rune/Manager/Interface/IMainRuneSlot.cs", "C#", 6, 0, 0, 2, 8
"/Users/fujitayuuta/Documents/GitHub/ZangiDon_001/Assets/Project/Script/Rune/Manager/Interface/IRuneListManager.cs", "C#", 13, 0, 3, 5, 21
"/Users/fujitayuuta/Documents/GitHub/ZangiDon_001/Assets/Project/Script/Rune/Manager/Interface/IRuneSelector.cs", "C#", 5, 0, 0, 3, 8
"/Users/fujitayuuta/Documents/GitHub/ZangiDon_001/Assets/Project/Script/Rune/Manager/Interface/IRuneSupplier.cs", "C#", 6, 0, 0, 1, 7
"/Users/fujitayuuta/Documents/GitHub/ZangiDon_001/Assets/Project/Script/Rune/Manager/Interface/ISubRuneSlot.cs", "C#", 11, 0, 0, 5, 16
"/Users/fujitayuuta/Documents/GitHub/ZangiDon_001/Assets/Project/Script/Rune/Manager/MainRuneSlot.cs", "C#", 12, 0, 0, 3, 15
"/Users/fujitayuuta/Documents/GitHub/ZangiDon_001/Assets/Project/Script/Rune/Manager/Module/SelectedRuneSender.cs", "C#", 30, 0, 0, 4, 34
"/Users/fujitayuuta/Documents/GitHub/ZangiDon_001/Assets/Project/Script/Rune/Manager/RuneFactory.cs", "C#", 33, 0, 0, 12, 45
"/Users/fujitayuuta/Documents/GitHub/ZangiDon_001/Assets/Project/Script/Rune/Manager/RuneSelector.cs", "C#", 45, 0, 4, 12, 61
"/Users/fujitayuuta/Documents/GitHub/ZangiDon_001/Assets/Project/Script/Rune/Manager/SubRuneSlot.cs", "C#", 30, 0, 0, 7, 37
"/Users/fujitayuuta/Documents/GitHub/ZangiDon_001/Assets/Project/Script/Rune/RuneData/AMainEffectData.cs", "C#", 12, 0, 0, 4, 16
"/Users/fujitayuuta/Documents/GitHub/ZangiDon_001/Assets/Project/Script/Rune/RuneData/Interface/IMainEffectData.cs", "C#", 6, 0, 0, 1, 7
"/Users/fujitayuuta/Documents/GitHub/ZangiDon_001/Assets/Project/Script/Rune/RuneData/Interface/IRuneEffectData.cs", "C#", 5, 0, 6, 0, 11
"/Users/fujitayuuta/Documents/GitHub/ZangiDon_001/Assets/Project/Script/Rune/RuneData/Interface/ISubEffectData.cs", "C#", 12, 0, 0, 7, 19
"/Users/fujitayuuta/Documents/GitHub/ZangiDon_001/Assets/Project/Script/Rune/RuneData/RuneData.cs", "C#", 19, 0, 3, 4, 26
"/Users/fujitayuuta/Documents/GitHub/ZangiDon_001/Assets/Project/Script/Rune/RuneData/SubEffectData.cs", "C#", 50, 0, 3, 17, 70
"/Users/fujitayuuta/Documents/GitHub/ZangiDon_001/Assets/Project/Script/Rune/RuneInstance/Factory/Interface/IMainEffectInstanceFactory.cs", "C#", 6, 0, 0, 1, 7
"/Users/fujitayuuta/Documents/GitHub/ZangiDon_001/Assets/Project/Script/Rune/RuneInstance/Factory/Interface/IRuneInstanceFactory.cs", "C#", 6, 0, 0, 1, 7
"/Users/fujitayuuta/Documents/GitHub/ZangiDon_001/Assets/Project/Script/Rune/RuneInstance/Factory/Interface/ISubEffectInstanceFactory.cs", "C#", 6, 0, 0, 1, 7
"/Users/fujitayuuta/Documents/GitHub/ZangiDon_001/Assets/Project/Script/Rune/RuneInstance/Factory/MainEffectInstanceFactory.cs", "C#", 17, 0, 0, 4, 21
"/Users/fujitayuuta/Documents/GitHub/ZangiDon_001/Assets/Project/Script/Rune/RuneInstance/Factory/RuneInstanceFactory.cs", "C#", 17, 0, 0, 4, 21
"/Users/fujitayuuta/Documents/GitHub/ZangiDon_001/Assets/Project/Script/Rune/RuneInstance/Factory/SubEffectInstanceFactory.cs", "C#", 29, 0, 0, 6, 35
"/Users/fujitayuuta/Documents/GitHub/ZangiDon_001/Assets/Project/Script/Rune/RuneInstance/Interface/IMainEffect.cs", "C#", 7, 0, 3, 3, 13
"/Users/fujitayuuta/Documents/GitHub/ZangiDon_001/Assets/Project/Script/Rune/RuneInstance/Interface/IRuneEffect.cs", "C#", 6, 0, 6, 0, 12
"/Users/fujitayuuta/Documents/GitHub/ZangiDon_001/Assets/Project/Script/Rune/RuneInstance/Interface/ISubEffect.cs", "C#", 14, 0, 3, 6, 23
"/Users/fujitayuuta/Documents/GitHub/ZangiDon_001/Assets/Project/Script/Rune/RuneInstance/MainEffectInstance.cs", "C#", 39, 0, 0, 10, 49
"/Users/fujitayuuta/Documents/GitHub/ZangiDon_001/Assets/Project/Script/Rune/RuneInstance/Module/RuneCastCount.cs", "C#", 47, 0, 3, 16, 66
"/Users/fujitayuuta/Documents/GitHub/ZangiDon_001/Assets/Project/Script/Rune/RuneInstance/RuneInstance.cs", "C#", 53, 0, 2, 13, 68
"/Users/fujitayuuta/Documents/GitHub/ZangiDon_001/Assets/Project/Script/Rune/RuneInstance/SubEffectInstance.cs", "C#", 45, 0, 0, 6, 51
"/Users/fujitayuuta/Documents/GitHub/ZangiDon_001/Assets/Project/Script/Scope/Bullet/BulletLifeTimeScope.cs", "C#", 14, 0, 0, 5, 19
"/Users/fujitayuuta/Documents/GitHub/ZangiDon_001/Assets/Project/Script/Scope/Camera/CameraLifeTimeScope.cs", "C#", 8, 0, 0, 3, 11
"/Users/fujitayuuta/Documents/GitHub/ZangiDon_001/Assets/Project/Script/Scope/GameLifeTimeScope.cs", "C#", 28, 0, 0, 11, 39
"/Users/fujitayuuta/Documents/GitHub/ZangiDon_001/Assets/Project/Script/Scope/RootLifeTimeScope.cs", "C#", 11, 0, 3, 5, 19
"/Users/fujitayuuta/Documents/GitHub/ZangiDon_001/Assets/Project/Script/Spawner/Character/CharacterSpawner.cs", "C#", 86, 0, 0, 32, 118
"/Users/fujitayuuta/Documents/GitHub/ZangiDon_001/Assets/Project/Script/Spawner/Character/Data/CharacterSpawnerData.cs", "C#", 7, 0, 0, 2, 9
"/Users/fujitayuuta/Documents/GitHub/ZangiDon_001/Assets/Project/Script/Spawner/Enemy/EnemySpawner.cs", "C#", 6, 0, 0, 3, 9
"/Users/fujitayuuta/Documents/GitHub/ZangiDon_001/Assets/Project/Script/Spawner/Interface/ISpawnDecorator.cs", "C#", 9, 0, 12, 3, 24
"/Users/fujitayuuta/Documents/GitHub/ZangiDon_001/Assets/Project/Script/Spawner/Interface/ISpawner.cs", "C#", 6, 0, 6, 3, 15
"/Users/fujitayuuta/Documents/GitHub/ZangiDon_001/Assets/Project/Script/Spawner/Position/Interface/ISpawnPositionManager.cs", "C#", 8, 0, 12, 4, 24
"/Users/fujitayuuta/Documents/GitHub/ZangiDon_001/Assets/Project/Script/StatusEffect/AStatusEffect.cs", "C#", 15, 0, 0, 5, 20
"/Users/fujitayuuta/Documents/GitHub/ZangiDon_001/Assets/Project/Script/StatusEffect/Data/StatusEffectData.cs", "C#", 11, 0, 0, 6, 17
"/Users/fujitayuuta/Documents/GitHub/ZangiDon_001/Assets/Project/Script/StatusEffect/Definition/EffectType.cs", "C#", 6, 0, 3, 0, 9
"/Users/fujitayuuta/Documents/GitHub/ZangiDon_001/Assets/Project/Script/UIControl/HealthPopUp/HealthPopUp.cs", "C#", 9, 0, 0, 4, 13
"/Users/fujitayuuta/Documents/GitHub/ZangiDon_001/Assets/Project/Script/UIControl/HealthPopUp/Interface/IHealthPopUpType.cs", "C#", 6, 0, 0, 2, 8
"/Users/fujitayuuta/Documents/GitHub/ZangiDon_001/Assets/Project/Script/UIControl/PlayerHUD/HealthBar/HealthState.cs", "C#", 14, 0, 6, 7, 27
"/Users/fujitayuuta/Documents/GitHub/ZangiDon_001/Assets/Project/Script/UIControl/PlayerHUD/HealthBar/Interface/IPlayerHealthBarPresenter.cs", "C#", 5, 0, 0, 3, 8
"/Users/fujitayuuta/Documents/GitHub/ZangiDon_001/Assets/Project/Script/UIControl/PlayerHUD/HealthBar/Interface/IPlayerHelathBarView.cs", "C#", 5, 0, 0, 1, 6
"/Users/fujitayuuta/Documents/GitHub/ZangiDon_001/Assets/Project/Script/UIControl/PlayerHUD/HealthBar/PlayerHealthBarPresenter.cs", "C#", 63, 0, 3, 22, 88
"/Users/fujitayuuta/Documents/GitHub/ZangiDon_001/Assets/Project/Script/UIControl/PlayerHUD/HealthBar/PlayerHealthView.cs", "C#", 46, 0, 4, 15, 65
"/Users/fujitayuuta/Documents/GitHub/ZangiDon_001/Assets/Project/Script/UIControl/PlayerHUD/Interface/IPlayerHUDFactory.cs", "C#", 6, 0, 0, 1, 7
"/Users/fujitayuuta/Documents/GitHub/ZangiDon_001/Assets/Project/Script/UIControl/PlayerHUD/Rune/ARuneListPresenter.cs", "C#", 91, 0, 5, 23, 119
"/Users/fujitayuuta/Documents/GitHub/ZangiDon_001/Assets/Project/Script/UIControl/PlayerHUD/Rune/ARuneListView.cs", "C#", 30, 0, 0, 8, 38
"/Users/fujitayuuta/Documents/GitHub/ZangiDon_001/Assets/Project/Script/UIControl/PlayerHUD/Rune/Definition/RunePosition.cs", "C#", 8, 0, 3, 0, 11
"/Users/fujitayuuta/Documents/GitHub/ZangiDon_001/Assets/Project/Script/UIControl/PlayerHUD/Rune/Interface/IRuneListPresenter.cs", "C#", 4, 0, 0, 1, 5
"/Users/fujitayuuta/Documents/GitHub/ZangiDon_001/Assets/Project/Script/UIControl/PlayerHUD/Rune/Interface/IRuneListView.cs", "C#", 7, 0, 0, 4, 11
"/Users/fujitayuuta/Documents/GitHub/ZangiDon_001/Assets/Project/Script/UIControl/PlayerHUD/Rune/RuneSelector/Interface/IRuneSelectorPresenter.cs", "C#", 5, 0, 0, 2, 7
"/Users/fujitayuuta/Documents/GitHub/ZangiDon_001/Assets/Project/Script/UIControl/PlayerHUD/Rune/RuneSelector/Interface/IRuneSelectorView.cs", "C#", 7, 0, 0, 2, 9
"/Users/fujitayuuta/Documents/GitHub/ZangiDon_001/Assets/Project/Script/UIControl/PlayerHUD/Rune/RuneSelector/Interface/ISelectorSlot.cs", "C#", 8, 0, 0, 3, 11
"/Users/fujitayuuta/Documents/GitHub/ZangiDon_001/Assets/Project/Script/UIControl/PlayerHUD/Rune/RuneSelector/RuneSelectorPresenter.cs", "C#", 18, 0, 3, 2, 23
"/Users/fujitayuuta/Documents/GitHub/ZangiDon_001/Assets/Project/Script/UIControl/PlayerHUD/Rune/RuneSelector/RuneSelectorView.cs", "C#", 13, 0, 0, 1, 14
"/Users/fujitayuuta/Documents/GitHub/ZangiDon_001/Assets/Project/Script/UIControl/PlayerHUD/Rune/RuneSlot/Main/Interface/IMainRuneSlotPresenter.cs", "C#", 5, 0, 0, 2, 7
"/Users/fujitayuuta/Documents/GitHub/ZangiDon_001/Assets/Project/Script/UIControl/PlayerHUD/Rune/RuneSlot/Main/Interface/IMainRuneSlotView.cs", "C#", 5, 0, 0, 2, 7
"/Users/fujitayuuta/Documents/GitHub/ZangiDon_001/Assets/Project/Script/UIControl/PlayerHUD/Rune/RuneSlot/Main/MainRuneSlotPresenter.cs", "C#", 10, 0, 0, 2, 12
"/Users/fujitayuuta/Documents/GitHub/ZangiDon_001/Assets/Project/Script/UIControl/PlayerHUD/Rune/RuneSlot/Main/MainRuneSlotView.cs", "C#", 10, 0, 0, 2, 12
"/Users/fujitayuuta/Documents/GitHub/ZangiDon_001/Assets/Project/Script/UIControl/PlayerHUD/Rune/RuneSlot/Sub/Interface/ISubRuneSlotPresenter.cs", "C#", 5, 0, 0, 2, 7
"/Users/fujitayuuta/Documents/GitHub/ZangiDon_001/Assets/Project/Script/UIControl/PlayerHUD/Rune/RuneSlot/Sub/Interface/ISubRuneSlotView.cs", "C#", 5, 0, 0, 2, 7
"/Users/fujitayuuta/Documents/GitHub/ZangiDon_001/Assets/Project/Script/UIControl/PlayerHUD/Rune/RuneSlot/Sub/SubRuneSlotPresenter.cs", "C#", 10, 0, 0, 2, 12
"/Users/fujitayuuta/Documents/GitHub/ZangiDon_001/Assets/Project/Script/UIControl/PlayerHUD/Rune/RuneSlot/Sub/SubRuneSlotView.cs", "C#", 10, 0, 0, 2, 12
"/Users/fujitayuuta/Documents/GitHub/ZangiDon_001/Assets/Project/Script/UIControl/PlayerHUD/Rune/RuneUI/AListView.cs", "C#", 7, 0, 0, 3, 10
"/Users/fujitayuuta/Documents/GitHub/ZangiDon_001/Assets/Project/Script/UIControl/PlayerHUD/Rune/RuneUI/Interface/IRuneAmountUI.cs", "C#", 7, 0, 0, 4, 11
"/Users/fujitayuuta/Documents/GitHub/ZangiDon_001/Assets/Project/Script/UIControl/PlayerHUD/Rune/RuneUI/Interface/IRuneUI.cs", "C#", 9, 0, 0, 4, 13
"/Users/fujitayuuta/Documents/GitHub/ZangiDon_001/Assets/Project/Script/UIControl/PlayerHUD/Rune/RuneUI/RuneAmountUI.cs", "C#", 42, 0, 0, 11, 53
"/Users/fujitayuuta/Documents/GitHub/ZangiDon_001/Assets/Project/Script/UIControl/PlayerHUD/Rune/RuneUI/RuneUI.cs", "C#", 79, 0, 11, 21, 111
"/Users/fujitayuuta/Documents/GitHub/ZangiDon_001/Assets/Project/Script/UIControl/StatusEffectUI/StatusEffectUI.cs", "C#", 26, 0, 5, 10, 41
"/Users/fujitayuuta/Documents/GitHub/ZangiDon_001/Assets/Project/Script/UIControl/Utility/AListPresenter.cs", "C#", 46, 0, 4, 17, 67
"/Users/fujitayuuta/Documents/GitHub/ZangiDon_001/Assets/Project/Script/UIControl/Utility/PlayerCharacterHolder.cs", "C#", 21, 0, 4, 6, 31
"/Users/fujitayuuta/Documents/GitHub/ZangiDon_001/Assets/Project/Script/UIControl/Utility/TextElement/FontSizeElement.cs", "C#", 17, 0, 0, 6, 23
"/Users/fujitayuuta/Documents/GitHub/ZangiDon_001/Assets/Project/Script/UIControl/Utility/TextElement/OutlineElement.cs", "C#", 6, 0, 0, 2, 8
"/Users/fujitayuuta/Documents/GitHub/ZangiDon_001/Assets/Project/Script/UIControl/Utility/TextElement/TextElement.cs", "C#", 8, 0, 0, 4, 12
"/Users/fujitayuuta/Documents/GitHub/ZangiDon_001/Assets/Project/Script/UIControl/Utility/UiDestroyModule.cs", "C#", 22, 0, 0, 7, 29
"/Users/fujitayuuta/Documents/GitHub/ZangiDon_001/Assets/Project/Script/Utility/ComponentsUtility.cs", "C#", 31, 0, 0, 8, 39
"Total", "-", 4071, 14, 472, 1276, 5833